/* http://www.timeanddate.com/library/abbreviations/timezones/ 에서 가져왔고, 날씨에서 현지 시간을 구해주기 위해 야후에서 가져온 각 도시의 타임존 약자를 사용해 값을 구해낸다 */ 
A	Alpha Time Zone	Military	UTC + 1 
ADT	Atlantic Daylight Time	Atlantic	UTC - 3 
ADT	Atlantic Daylight Time	North America	UTC - 3 
AFT	Afghanistan Time	Asia	UTC + 4:30 
AKDT	Alaska Daylight Time	North America	UTC - 8 
AKST	Alaska Standard Time	North America	UTC - 9 
ALMT	Alma-Ata Time	Asia	UTC + 6 
AMST	Armenia Summer Time	Asia	UTC + 5 
AMST	Amazon Summer Time	South America	UTC - 3 
AMT	Armenia Time	Asia	UTC + 4 
AMT	Amazon Time	South America	UTC - 4 
ANAST	Anadyr Summer Time	Asia	UTC + 12 
ANAT	Anadyr Time	Asia	UTC + 12 
AQTT	Aqtobe Time	Asia	UTC + 5 
ART	Argentina Time	South America	UTC - 3 
AST	Arabia Standard Time	Asia	UTC + 3 
AST	Atlantic Standard Time	Atlantic	UTC - 4 
AST	Atlantic Standard Time	Caribbean	UTC - 4 
AST	Atlantic Standard Time	North America	UTC - 4 
AZOST	Azores Summer Time	Atlantic	UTC
AZOT	Azores Time	Atlantic	UTC - 1 
AZST	Azerbaijan Summer Time	Asia	UTC + 5 
AZT	Azerbaijan Time	Asia	UTC + 4 
B	Bravo Time Zone	Military	UTC + 2 
BNT	Brunei Darussalam Time	Asia	UTC + 8 
BOT	Bolivia Time	South America	UTC - 4 
BRST	Brasilia Summer Time	South America	UTC - 2 
BRT	Brasília time	South America	UTC - 3 
BST	Bangladesh Standard Time	Asia	UTC + 6 
BST	British Summer Time	Europe	UTC + 1 
BTT	Bhutan Time	Asia	UTC + 6 
C	Charlie Time Zone	Military	UTC + 3 
CAST	Casey Time	Antarctica	UTC + 8 
CAT	Central Africa Time	Africa	UTC + 2 
CCT	Cocos Islands Time	Indian Ocean	UTC + 6:30 
CDT	Central Daylight Time	Australia	UTC + 10:30 
CDT	Cuba Daylight Time	Caribbean	UTC - 4 
CDT	Central Daylight Time	North America	UTC - 5 
CEST	Central European Summer Time	Europe	UTC + 2 
CET	Central European Time	Africa	UTC + 1 
CET	Central European Time	Europe	UTC + 1 
CHADT	Chatham Island Daylight Time	Pacific	UTC + 13:45 
CHAST	Chatham Island Standard Time	Pacific	UTC + 12:45 
CKT	Cook Island Time	Pacific	UTC - 10 
CLST	Chile Summer Time	South America	UTC - 3 
CLT	Chile Standard Time	South America	UTC - 4 
COT	Colombia Time	South America	UTC - 5 
CST	China Standard Time	Asia	UTC + 8 
CST	Central Standard Time	Australia	UTC + 9:30 
CST	Central Standard Time	Central America	UTC - 6 
CST	Cuba Standard Time	Caribbean	UTC - 5 
CST	Central Standard Time	North America	UTC - 6 
CVT	Cape Verde Time	Africa	UTC - 1 
CXT	Christmas Island Time	Australia	UTC + 7 
ChST	Chamorro Standard Time	Pacific	UTC + 10 
D	Delta Time Zone	Military	UTC + 4 
DAVT	Davis Time	Antarctica	UTC + 7 
E	Echo Time Zone	Military	UTC + 5 
EASST	Easter Island Summer Time	Pacific	UTC - 5 
EAST	Easter Island Standard Time	Pacific	UTC - 6 
EAT	Eastern Africa Time	Africa	UTC + 3 
EAT	East Africa Time	Indian Ocean	UTC + 3 
ECT	Ecuador Time	South America	UTC - 5 
AEDT	Eastern Daylight Time	Australia	UTC + 11 
EDT	Eastern Daylight Time	Caribbean	UTC - 4 
EDT	Eastern Daylight Time	North America	UTC - 4 
EEST	Eastern European Summer Time	Africa	UTC + 3 
EEST	Eastern European Summer Time	Asia	UTC + 3 
EEST	Eastern European Summer Time	Europe	UTC + 3 
EET	Eastern European Time	Africa	UTC + 2 
EET	Eastern European Time	Asia	UTC + 2 
EET	Eastern European Time	Europe	UTC + 2 
EGST	Eastern Greenland Summer Time	North America	UTC
EGT	East Greenland Time	North America	UTC - 1 
AEST	Eastern Standard Time	Australia	UTC + 10 
EST	Eastern Standard Time	Central America	UTC - 5 
EST	Eastern Standard Time	Caribbean	UTC - 5 
EST	Eastern Standard Time	North America	UTC - 5 
ET	Tiempo del Este	Central America	UTC - 5 
ET	Tiempo del Este	Caribbean	UTC - 5 
ET	Tiempo Del Este	North America	UTC - 5 
F	Foxtrot Time Zone	Military	UTC + 6 
FJST	Fiji Summer Time	Pacific	UTC + 13 
FJT	Fiji Time	Pacific	UTC + 12 
FKST	Falkland Islands Summer Time	South America	UTC - 3 
FKT	Falkland Island Time	South America	UTC - 4 
FNT	Fernando de Noronha Time	South America	UTC - 2 
G	Golf Time Zone	Military	UTC + 7 
GALT	Galapagos Time	Pacific	UTC - 6 
GAMT	Gambier Time	Pacific	UTC - 9 
GET	Georgia Standard Time	Asia	UTC + 4 
GFT	French Guiana Time	South America	UTC - 3 
GILT	Gilbert Island Time	Pacific	UTC + 12 
GMT	Greenwich Mean Time	Africa	UTC
GMT	Greenwich Mean Time	Europe	UTC
GST	Gulf Standard Time	Asia	UTC + 4 
GYT	Guyana Time	South America	UTC - 4 
H	Hotel Time Zone	Military	UTC + 8 
HAA	Heure Avancée de l'Atlantique	Atlantic	UTC - 3 
HAA	Heure Avancée de l'Atlantique	North America	UTC - 3 
HAC	Heure Avancée du Centre	North America	UTC - 5 
HADT	Hawaii-Aleutian Daylight Time	North America	UTC - 9 
HAE	Heure Avancée de l'Est	Caribbean	UTC - 4 
HAE	Heure Avancée de l'Est	North America	UTC - 4 
HAP	Heure Avancée du Pacifique	North America	UTC - 7 
HAR	Heure Avancée des Rocheuses	North America	UTC - 6 
HAST	Hawaii-Aleutian Standard Time	North America	UTC - 10 
HAT	Heure Avancée de Terre-Neuve	North America	UTC - 2:30 
HAY	Heure Avancée du Yukon	North America	UTC - 8 
HKT	Hong Kong Time	Asia	UTC + 8 
HLV	Hora Legal de Venezuela	South America	UTC - 4:30 
HNA	Heure Normale de l'Atlantique	Atlantic	UTC - 4 
HNA	Heure Normale de l'Atlantique	Caribbean	UTC - 4 
HNA	Heure Normale de l'Atlantique	North America	UTC - 4 
HNC	Heure Normale du Centre	Central America	UTC - 6 
HNC	Heure Normale du Centre	North America	UTC - 6 
HNE	Heure Normale de l'Est	Central America	UTC - 5 
HNE	Heure Normale de l'Est	Caribbean	UTC - 5 
HNE	Heure Normale de l'Est	North America	UTC - 5 
HNP	Heure Normale du Pacifique	North America	UTC - 8 
HNR	Heure Normale des Rocheuses	North America	UTC - 7 
HNT	Heure Normale de Terre-Neuve	North America	UTC - 3:30 
HNY	Heure Normale du Yukon	North America	UTC - 9 
HOVT	Hovd Time	Asia	UTC + 7 
I	India Time Zone	Military	UTC + 9 
ICT	Indochina Time	Asia	UTC + 7 
IDT	Israel Daylight Time	Asia	UTC + 3 
IOT	Indian Chagos Time	Indian Ocean	UTC + 6 
IRDT	Iran Daylight Time	Asia	UTC + 4:30 
IRKST	Irkutsk Summer Time	Asia	UTC + 9 
IRKT	Irkutsk Time	Asia	UTC + 9 
IRST	Iran Standard Time	Asia	UTC + 3:30 
IST	Israel Standard Time	Asia	UTC + 2 
IST	India Standard Time	Asia	UTC + 5:30 
IST	Irish Standard Time	Europe	UTC + 1 
JST	Japan Standard Time	Asia	UTC + 9 
K	Kilo Time Zone	Military	UTC + 10 
KGT	Kyrgyzstan Time	Asia	UTC + 6 
KRAST	Krasnoyarsk Summer Time	Asia	UTC + 8 
KRAT	Krasnoyarsk Time	Asia	UTC + 8 
KST	Korea Standard Time	Asia	UTC + 9 
KUYT	Kuybyshev Time	Europe	UTC + 4 
L	Lima Time Zone	Military	UTC + 11 
LHDT	Lord Howe Daylight Time	Australia	UTC + 11 
LHST	Lord Howe Standard Time	Australia	UTC + 10:30 
LINT	Line Islands Time	Pacific	UTC + 14 
M	Mike Time Zone	Military	UTC + 12 
MAGST	Magadan Summer Time	Asia	UTC + 12 
MAGT	Magadan Time	Asia	UTC + 12 
MART	Marquesas Time	Pacific	UTC - 9:30 
MAWT	Mawson Time	Antarctica	UTC + 5 
MDT	Mountain Daylight Time	North America	UTC - 6 
MESZ	Mitteleuropäische Sommerzeit	Europe	UTC + 2 
MEZ	Mitteleuropäische Zeit	Africa	UTC + 1 
MHT	Marshall Islands Time	Pacific	UTC + 12 
MMT	Myanmar Time	Asia	UTC + 6:30 
MSD	Moscow Daylight Time	Europe	UTC + 4 
MSK	Moscow Standard Time	Europe	UTC + 4 
MST	Mountain Standard Time	North America	UTC - 7 
MUT	Mauritius Time	Africa	UTC + 4 
MVT	Maldives Time	Asia	UTC + 5 
MYT	Malaysia Time	Asia	UTC + 8 
N	November Time Zone	Military	UTC - 1 
NCT	New Caledonia Time	Pacific	UTC + 11 
NDT	Newfoundland Daylight Time	North America	UTC - 2:30 
NFT	Norfolk Time	Australia	UTC + 11:30 
NOVST	Novosibirsk Summer Time	Asia	UTC + 7 
NOVT	Novosibirsk Time	Asia	UTC + 6 
NPT	Nepal Time	Asia	UTC + 5:45 
NST	Newfoundland Standard Time	North America	UTC - 3:30 
NUT	Niue Time	Pacific	UTC - 11 
NZDT	New Zealand Daylight Time	Antarctica	UTC + 13 
NZDT	New Zealand Daylight Time	Pacific	UTC + 13 
NZST	New Zealand Standard Time	Antarctica	UTC + 12 
NZST	New Zealand Standard Time	Pacific	UTC + 12 
O	Oscar Time Zone	Military	UTC - 2 
OMSST	Omsk Summer Time	Asia	UTC + 7 
OMST	Omsk Standard Time	Asia	UTC + 7 
P	Papa Time Zone	Military	UTC - 3 
PDT	Pacific Daylight Time	North America	UTC - 7 
PET	Peru Time	South America	UTC - 5 
PETST	Kamchatka Summer Time	Asia	UTC + 12 
PETT	Kamchatka Time	Asia	UTC + 12 
PGT	Papua New Guinea Time	Pacific	UTC + 10 
PHOT	Phoenix Island Time	Pacific	UTC + 13 
PHT	Philippine Time	Asia	UTC + 8 
PKT	Pakistan Standard Time	Asia	UTC + 5 
PMDT	Pierre & Miquelon Daylight Time	North America	UTC - 2 
PMST	Pierre & Miquelon Standard Time	North America	UTC - 3 
PONT	Pohnpei Standard Time	Pacific	UTC + 11 
PST	Pacific Standard Time	North America	UTC - 8 
PST	Pitcairn Standard Time	Pacific	UTC - 8 
PT	Tiempo del Pacífico	North America	UTC - 8 
PWT	Palau Time	Pacific	UTC + 9 
PYST	Paraguay Summer Time	South America	UTC - 3 
PYT	Paraguay Time	South America	UTC - 4 
Q	Quebec Time Zone	Military	UTC - 4 
R	Romeo Time Zone	Military	UTC - 5 
RET	Reunion Time	Africa	UTC + 4 
S	Sierra Time Zone	Military	UTC - 6 
SAMT	Samara Time	Europe	UTC + 4 
SAST	South Africa Standard Time	Africa	UTC + 2 
SBT	Solomon IslandsTime	Pacific	UTC + 11 
SCT	Seychelles Time	Africa	UTC + 4 
SGT	Singapore Time	Asia	UTC + 8 
SRT	Suriname Time	South America	UTC - 3 
SST	Samoa Standard Time	Pacific	UTC - 11 
T	Tango Time Zone	Military	UTC - 7 
TAHT	Tahiti Time	Pacific	UTC - 10 
TFT	French Southern and Antarctic Time	Indian Ocean	UTC + 5 
TJT	Tajikistan Time	Asia	UTC + 5 
TKT	Tokelau Time	Pacific	UTC + 13 
TLT	East Timor Time	Asia	UTC + 9 
TMT	Turkmenistan Time	Asia	UTC + 5 
TVT	Tuvalu Time	Pacific	UTC + 12 
U	Uniform Time Zone	Military	UTC - 8 
ULAT	Ulaanbaatar Time	Asia	UTC + 8 
UYST	Uruguay Summer Time	South America	UTC - 2 
UYT	Uruguay Time	South America	UTC - 3 
UZT	Uzbekistan Time	Asia	UTC + 5 
V	Victor Time Zone	Military	UTC - 9 
VET	Venezuelan Standard Time	South America	UTC - 4:30 
VLAST	Vladivostok Summer Time	Asia	UTC + 11 
VLAT	Vladivostok Time	Asia	UTC + 11 
VUT	Vanuatu Time	Pacific	UTC + 11 
W	Whiskey Time Zone	Military	UTC - 10 
WAST	West Africa Summer Time	Africa	UTC + 2 
WAT	West Africa Time	Africa	UTC + 1 
WDT	Western Daylight Time	Australia	UTC + 9 
WEST	Western European Summer Time	Africa	UTC + 1 
WEST	Western European Summer Time	Europe	UTC + 1 
WESZ	Westeuropäische Sommerzeit	Africa	UTC + 1 
WET	Western European Time	Africa	UTC
WET	Western European Time	Europe	UTC
WEZ	Westeuropäische Zeit	Europe	UTC
WFT	Wallis and Futuna Time	Pacific	UTC + 12 
WGST	Western Greenland Summer Time	North America	UTC - 2 
WGT	West Greenland Time	North America	UTC - 3 
WIB	Western Indonesian Time	Asia	UTC + 7 
WIT	Eastern Indonesian Time	Asia	UTC + 9 
WITA	Central Indonesian Time	Asia	UTC + 8 
WST	Western Sahara Summer Time	Africa	UTC + 1 
WST	Western Standard Time	Australia	UTC + 8 
WST	West Samoa Time	Pacific	UTC + 13 
WT	Western Sahara Standard Time	Africa	UTC
X	X-ray Time Zone	Military	UTC - 11 
Y	Yankee Time Zone	Military	UTC - 12 
YAKST	Yakutsk Summer Time	Asia	UTC + 10 
YAKT	Yakutsk Time	Asia	UTC + 10 
YAPT	Yap Time	Pacific	UTC + 10 
YEKST	Yekaterinburg Summer Time	Asia	UTC + 6 
YEKT	 Yekaterinburg Time	Asia	UTC + 6 
Z	Zulu Time Zone	Military	UTC